27
22
1011100010010010100001
1010001010010010111111
1111101011110010101010
0010111010101010101010
1110100010111110101010
0000111110101000101000
0111101000100000101111
0000001000111110101000
0111100111100011101001
0100100100000000001001
1100111101011111111111
0000100001001000001001
1111111101001001001001
0100010111001101011101
0100000000000101001001
0111101111111101011101
0000001001010001001001
1111111001011101011101
0000010001001001001001
1111110111001001111101
0000101000011100000011
0001111111101000011100
0001001010011100010100
1111101011001000010100
0100101001101111110111
0101101000110000100001
0101011000011000111101